[level]
tileset = 2tile.png
scale = 16
map = ...............
      .#####.##......
      .#...#..#......
      .#...####......
      .##.##.........
      ...............
      ...............
      ...............
      ...............
      ...............
      ......#........
      ...............
      ...............
      ...............
      ...............
	  
[.]
name = ground
tile = 0,0

[#]
name = water
tile = 1,0