[level]
tileset = 8tile.png
scale = 8
map = ...............
      .#####.##......
      .#...#..#......
      .#...####......
      .##.##.........
      ...............
      ...............
      ...............
      ...............
      ...............
      ,,,,,,,,,,,,,,,
      ###############
      ###############
      ###############
      ###############
	  
[.]
name = grass
tile = 0,1

[,]
name = grass2
tile = 1,1

[#]
name = water
tile = 0,4

[#]
name = water
tile = 0,4